NO ./image/wall1.xpm
SO ./image/wall2.xpm
WE ./image/wall3.xpm
EA ./image/wall4.xpm

F 0,0,255
C 182,182,0

           111111111111111
         11000S00011111111
       1100000000000011111
      10000000000000000111
     100000000000000000011
    1000011000000001100001
    10001  10000001  10001
    10001  10000001  10001
    10001  10000001  10001
    10001  10000001  10001
    10001  10000001  10001
    1000011000000001100001
    1000000000c00000000001
    1100000001010000000011
    11100000c1c1c000000111
    1111100000000000011111
    11111110c010c001111111
    1111111010c01001111111
    11111110c010c001111111
    1111111000000001111111
    1111111111111111111111