NO ./image/wall1.xpm
SO ./image/wall2.xpm
WE ./image/wall3.xpm
EA ./image/wall4.xpm

F 124,252,0
C 135,206,235

        1111111111111111111111111
        1000000000110000000000001
        1011000001110000000000001
        1001000000000000000000001
111111111011000001110000000000001
100000000011000001110111111111111
11110111111111011100000010001
11110111111111011101010010001
11000000110101011100000010001
10000000000000001100000010001
10000000000000001101010010001
11000001110101011111011110N0111
11110111 1110101 101111010001
11111111 1111111 111111111111

ok
1111111
1000001
1000001
100N001
1000001
1111111

KO
1111111
1000000
1000001
100N001
1000001
1111111

??
1111111111111111
1000000000000100
1000000000000100
100N000000000100
1000000000000100
1111111111111111

KO?
1111111
1000001
100 001
100N001
1000001
1111111