NO ./image/wall4.xpm
SO ./image/wall4.xpm
WE ./image/wall4.xpm
EA ./image/wall4.xpm

C 135,206,235
F 124,252,0

 1111 1
100001
1000101
100N001
1000001
11111 1