NO ./image/wall1.xpm
SO ./image/wall2.xpm
WE ./image/wall3.xpm
EA ./image/wall4.xpm

C 135,206,235
F 124,240,0

                                                        111111
                                                        11010111111111
                11111111111111111                       11000000000001
                100000000000000011111111111111111111111111010010S10011
                1010000010000010c000000000000000000000000c000000000001
                100000000000000011111111111111111001111111111111c11111
                10001000100010001               1001           101
                10000000000000001               1001           101111111111111111
                10101010101010101               1001           100000000000000001
                10000000000000001           111110011111       111111111111111101
                10001000100100001           100000000001                      101
                10000000000000001           100000000001                      101
                101000001000010011111111111110001001000111111111111111111111111c1
                1000000000000000c000000000000000000000000000000000000000000000c01
                111110111111111111111111111110001001000111111111111111111111111c1
                    1c1                     100000000001                      101
                11111011111111111           100000000001                      101
                10000000000000001           111110011111                      101
                10100000100000101               1001                          101
                10000000000000001111111111111111100111111111111111111111111111101
                10001000100010000000000000000000c00c00000000000000000000000000001
                10000000000000001111111111111111111111111111111111111111111111111
                10101010001010101
                10000000000000001
                10001000100100001
                10000000000000001
                10100000100001001111111111111
                1000000000000000c000000000001
                11111111111111111111111111101
                                         11011
                                        11000111111111
11111111111111111                       11000000000001
100000000000000011111111111111111111111111010010010011
1010000010000010c000000000000000000000000c000000000001
100000000000000011111111111111111001111111111111c11111
10001000100010001               1001           101
10000000000000001               1001           101111111111111111
10101010001010101               1001           100000000000000001
10000000000000001           111110011111       111111111111111101
10001000100100001           100000000001                      101
10000000000000001           100000000001                      101
101000001000010011111111111110001001000111111111111111111111111c1111111111111111111111111111111111111111111111111111111111111111111111111111111111111111111111111111111
1000000000000000c0000000000000000000000c0000000000000000000000c0c000000000000000000000000000000000000000000000000000000000000000000000000000000000000000000000000000001
11111c111111111111111111111110001001000111111111111111111111111c1111111111111111111111111111111111111111111111111111111111111111111111111111111111111111111111111111111
    101                     100000000001                      101
11111011111111111           100000000001                      101
10000000000000001           111110011111                      101
10100000100000101               1001                          101
10000000000000001111111111111111100111111111111111111111111111101
1000100010001000c000000000000000000000000000000000000000000000001
10000000000000001111111111111111111111111111111111111111111111111
10101010001010101
10000000000000001
10001000100100001
10000000000000001
10100000100001001
10000000000000001
11111111111111111