NO ./image/wall1.xpm
SO ./image/wall2.xpm
WE ./image/wall3.xpm
EA ./image/wall4.xpm

C 135,206,235
F 124,240,0

      11111111111111111
     1000000000000000001
     100111111111111111
     101
     101
     100111111111111111111111111111
     1000000000000000000000000000001
      111111111111111111111111111001
                                 101
                                 101
 11111111111111111111111111111111001
100000W00000000000000000000000000001
 1111111111111111111111111111111111